####################
####             ###
###               ##
##               ..#
####################
4 3
8 2
4 2